11111111
1P000C01
10001101
1C0000E1
11111111

