1111111
1P1C1C1
1000001
1C01E11
1111111