1111111
1PCC0C1
101C1C1
1C00E01
1111111

