1111111
1P1C1C1
1E0C101
1C00001
1111111