1111111
1P1C1C1
1E0C111
1C00001
1111111