11E11111
1PE00C01
10001101
1C00PPE1
11111111

