1111111
1PCCCC1
101CCC1
1C00E01
1111111

